{
  "name": "HHKB",
  "vendorProductId": 1212678145,
  "macros": ["", "", "", "", "", "", "", "", "", "", "", "", "", "", "", ""],
  "layers": [
    [
      "KC_2",
      "KC_Q",
      "KC_W",
      "KC_S",
      "KC_A",
      "KC_Z",
      "KC_X",
      "KC_C",
      "KC_3",
      "KC_4",
      "KC_R",
      "KC_E",
      "KC_D",
      "KC_F",
      "KC_V",
      "KC_B",
      "KC_5",
      "KC_6",
      "KC_Y",
      "KC_T",
      "KC_G",
      "KC_H",
      "KC_N",
      "KC_NO",
      "KC_1",
      "KC_ESC",
      "KC_TAB",
      "KC_LCTL",
      "KC_LSFT",
      "KC_LGUI",
      "KC_LALT",
      "KC_SPC",
      "KC_7",
      "KC_8",
      "KC_U",
      "KC_I",
      "KC_K",
      "KC_J",
      "KC_M",
      "KC_NO",
      "KC_GRV",
      "KC_BSLS",
      "KC_BSPC",
      "KC_ENT",
      "MO(1)",
      "KC_RSFT",
      "TO(3)",
      "TG(2)",
      "KC_9",
      "KC_0",
      "KC_O",
      "KC_P",
      "KC_SCLN",
      "KC_L",
      "KC_COMM",
      "KC_NO",
      "KC_MINS",
      "KC_EQL",
      "KC_RBRC",
      "KC_LBRC",
      "KC_QUOT",
      "KC_SLSH",
      "KC_DOT",
      "KC_NO"
    ],
    [
      "KC_F2",
      "KC_TRNS",
      "KC_UP",
      "KC_DOWN",
      "KC_LEFT",
      "KC_TRNS",
      "KC_TRNS",
      "KC_TRNS",
      "KC_F3",
      "KC_F4",
      "KC_TRNS",
      "KC_TRNS",
      "KC_RGHT",
      "KC_TRNS",
      "KC_TRNS",
      "KC_TRNS",
      "KC_F5",
      "KC_F6",
      "KC_TRNS",
      "KC_TRNS",
      "KC_TRNS",
      "KC_TRNS",
      "KC_TRNS",
      "KC_NO",
      "KC_F1",
      "KC_TRNS",
      "KC_TRNS",
      "KC_TRNS",
      "KC_TRNS",
      "KC_TRNS",
      "KC_TRNS",
      "KC_TRNS",
      "KC_F7",
      "KC_F8",
      "KC_TRNS",
      "KC_TRNS",
      "KC_TRNS",
      "KC_TRNS",
      "KC_TRNS",
      "KC_NO",
      "KC_PSCR",
      "KC_DEL",
      "KC_TRNS",
      "KC_TRNS",
      "KC_TRNS",
      "KC_TRNS",
      "KC_TRNS",
      "RESET",
      "KC_F9",
      "KC_F10",
      "KC_TRNS",
      "KC_TRNS",
      "KC_TRNS",
      "KC_TRNS",
      "KC_TRNS",
      "KC_NO",
      "KC_F11",
      "KC_F12",
      "KC_TRNS",
      "KC_TRNS",
      "KC_TRNS",
      "KC_TRNS",
      "KC_TRNS",
      "KC_NO"
    ],
    [
      "KC_TRNS",
      "KC_TRNS",
      "KC_TRNS",
      "KC_TRNS",
      "KC_TRNS",
      "KC_TRNS",
      "KC_TRNS",
      "KC_TRNS",
      "KC_TRNS",
      "KC_TRNS",
      "KC_TRNS",
      "KC_TRNS",
      "KC_TRNS",
      "KC_TRNS",
      "KC_TRNS",
      "KC_TRNS",
      "KC_TRNS",
      "KC_TRNS",
      "KC_TRNS",
      "KC_TRNS",
      "KC_TRNS",
      "KC_TRNS",
      "KC_TRNS",
      "KC_NO",
      "KC_TRNS",
      "KC_TRNS",
      "KC_TRNS",
      "KC_TRNS",
      "KC_TRNS",
      "KC_TRNS",
      "KC_TRNS",
      "KC_TRNS",
      "KC_TRNS",
      "KC_TRNS",
      "KC_TRNS",
      "KC_TRNS",
      "KC_TRNS",
      "KC_TRNS",
      "KC_TRNS",
      "KC_NO",
      "KC_TRNS",
      "KC_TRNS",
      "KC_TRNS",
      "KC_TRNS",
      "KC_TRNS",
      "KC_TRNS",
      "KC_TRNS",
      "KC_TRNS",
      "KC_TRNS",
      "KC_TRNS",
      "KC_TRNS",
      "KC_UP",
      "KC_DOWN",
      "KC_LEFT",
      "KC_TRNS",
      "KC_NO",
      "KC_TRNS",
      "KC_TRNS",
      "KC_TRNS",
      "KC_TRNS",
      "KC_RGHT",
      "KC_TRNS",
      "KC_TRNS",
      "KC_NO"
    ],
    [
      "KC_F2",
      "KC_TRNS",
      "KC_TRNS",
      "KC_TRNS",
      "KC_TRNS",
      "KC_TRNS",
      "KC_TRNS",
      "KC_TRNS",
      "KC_F3",
      "KC_F4",
      "KC_TRNS",
      "KC_TRNS",
      "KC_TRNS",
      "KC_TRNS",
      "KC_TRNS",
      "KC_TRNS",
      "KC_F5",
      "KC_F6",
      "KC_TRNS",
      "KC_TRNS",
      "KC_TRNS",
      "KC_TRNS",
      "KC_TRNS",
      "KC_NO",
      "KC_F1",
      "KC_TRNS",
      "KC_TRNS",
      "KC_TRNS",
      "KC_TRNS",
      "KC_TRNS",
      "KC_TRNS",
      "KC_TRNS",
      "KC_F7",
      "KC_F8",
      "KC_TRNS",
      "KC_TRNS",
      "KC_TRNS",
      "KC_TRNS",
      "KC_TRNS",
      "KC_NO",
      "KC_TRNS",
      "KC_TRNS",
      "KC_TRNS",
      "KC_TRNS",
      "KC_TRNS",
      "KC_TRNS",
      "KC_TRNS",
      "KC_TRNS",
      "KC_F9",
      "KC_F10",
      "KC_TRNS",
      "KC_TRNS",
      "KC_TRNS",
      "KC_TRNS",
      "KC_TRNS",
      "KC_NO",
      "KC_F11",
      "KC_F12",
      "KC_TRNS",
      "KC_TRNS",
      "KC_TRNS",
      "KC_TRNS",
      "KC_TRNS",
      "KC_NO"
    ]
  ],
  "encoders": []
}